   NO              ./path_to_the_north_texture
SO       ./path_to_the_south_texture
WE ./path_to_the_west_texture    
EA ./path_to_the_east_texture
                             
F    250, 100, 0
C 225,30,0

        11111111111111111111111110001 1                                  
        100000000110000W00000001
        1011000001110000000000001
        111

  